width = 15
height = 22
-----#0#0^9999#0#0-----
-----#0 3 3 3#0-----
-----#0 3 3 3#0-----
-----#0 3 3 3#0-----
-----#0 3 3 3#0-----
#0#0#0#0#0#0#0=9#0#0#0#0#0#0#0
#0 2 2 2 2 2 2 2 2 2 2 2 2 2#0
#0 2 2 2 2 2 2 2 2 2 2 2 2 2#0
#0 2 2 2 2 2 2 2 2 2 2 2 2 2#0
#0 2 2 2 2 2 2 2 2 2 2 2 2 2#0
#0 2 2 2 2 2 2 2 2 2 2 2 2 2#0
#0 2 2 2 2 2 2 2 2 2 2 2 2 2#0
#0 2 2 2 2 2 2 2 2 2 2 2 2 2#0
#0 2 2 2 2 2 2 2 2 2 2 2 2 2#0
#0 2 2 2 2 2 2 2 2 2 2 2 2 2#0
#0 2 2 2 2 2 2 2 2 2 2 2 2 2#0
#0 2 2 2 2 2 2 2 2 2 2 2 2 2#0
#0 2 2 2 2 2 2 2 2 2 2 2 2 2#0
#0 2 2 2 2 2 2 2 2 2 2 2 2 2#0
#0#0#0#0#0#0 0 0 0#0#0#0#0#0#0
-----#0 0 0 0#0-----
-----#0#0#0#0#0-----
